O...........
.P...T...P..
..D...U.....
........d...
......T...P.
U...........
.....P.O....
.....D.P....
..d.......T.
P.......P...
...P.......O
X.....T..U..