O...........
.....T......
..D...U.....
........d...
......T.....
U...........
.......O....
.....D......
..d.......T.
............
...........O
X.....T..U..