O...........
.P...T...P..
..D.........
........d...
......T...P.
............
.....P.O....
.....D.P....
..d.......T.
P.......P...
...P.......O
X.....T.....